1111111111111
1E010000000C1
1010011111001
10P0111C00001
1111111111111